token = token
owner = id

prefix = "-"

game = " "

status = ONLINE

songinstatus=false

altprefix = "NONE"

success = "ðŸŽ¶"
warning = "ðŸ’¡"
error = "ðŸš«"
loading = "âŒš"
searching = "ðŸ”Ž"

help = help

npimages = true

stayinchannel = false

maxtime = 0

alonetimeuntilstop = 0

playlistsfolder = "Playlists"

updatealerts=true

// Currently available providers: "A-Z Lyrics", "Genius", "MusicMatch", "LyricsFreak"
lyrics.default = "A-Z Lyrics"

aliases {
  settings = [status]
  lyrics = [l]
  nowplaying = [np]
  play = [p]
  playlists = [pl]
  queue = [q]
  remove = [r]
  scsearch = [scs]
  search = [ sc]
  shuffle = [sh]
  skip = [s]
  prefix = [ setprefix ]
  setdj = []
  settc = []
  setvc = []
  forceremove = [ forcedelete, modremove, moddelete ]
  forceskip = [fs]
  movetrack = [m]
  pause = [pa]
  playnext = [pn]
  repeat = [rp]
  skipto = [jt]
  stop = []
  volume = [vol]
}

eval= false
